13 7
XXXXXXXXXXXXX
X           X
XXXXXXXXXXXXX
X           X
X  XXXXXXX  X
X           X
XXXXXXEXXXXXX
